Apesar	(O,|,|)
das	(O,|,|)
próximas	(O,|,|)
eleições	(O,|,|)
federais	(O,|,|)
legislativas	(O,|,|)
se	(O,|,|)
realizarem	(O,|,|)
apenas	(O,|,|)
em	(O,|,|)
Setembro	(O,|,|)
do	(O,|,|)
ano	(O,|,|)
que	(O,|,|)
vem	(O,|,|)
,	(O,|,|)
2016	(O,|,|)
será	(O,|,|)
decisivo	(O,|,|)
para	(O,|,|)
o	(O,|,|)
futuro	(O,|,|)
político	(O,|,|)
de	(O,|,|)
Merkel	(O,|,|)
.	(O,|,|)
Durante	(I,premise,34)
este	(I,premise,33)
ano	(I,premise,32)
,	(I,premise,31)
haverá	(I,premise,30)
cinco	(I,premise,29)
eleições	(I,premise,28)
regionais	(I,premise,27)
nos	(I,premise,26)
Lander	(I,premise,25)
.	(O,|,|)
Se	(I,claim,11)
a	(I,claim,10)
CDU	(I,claim,9)
sofrer	(I,claim,8)
maus	(I,claim,7)
resultados	(I,claim,6)
–	(O,|,|)
e	(O,|,|)
sabe	(O,|,|)
-se	(O,|,|)
como	(O,|,|)
as	(I,premise,0)
eleições	(I,premise,0)
regionais	(I,premise,0)
costumam	(I,premise,0)
ser	(I,premise,0)
complicadas	(I,premise,0)
para	(I,premise,0)
os	(I,premise,0)
partidos	(I,premise,0)
no	(I,premise,0)
poder	(I,premise,0)
–	(O,|,|)
a	(I,claim,0)
vida	(I,claim,0)
ficará	(I,claim,0)
muito	(I,claim,0)
difícil	(I,claim,0)
para	(I,claim,0)
Merkel	(I,claim,0)
.	(O,|,|)
