Apesar	(O,|,|)
das	(O,|,|)
próximas	(O,|,|)
eleições	(O,|,|)
federais	(O,|,|)
legislativas	(O,|,|)
se	(O,|,|)
realizarem	(O,|,|)
apenas	(O,|,|)
em	(O,|,|)
Setembro	(O,|,|)
do	(O,|,|)
ano	(O,|,|)
que	(O,|,|)
vem	(O,|,|)
,	(O,|,|)
2016	(I,claim,10)
será	(I,claim,9)
decisivo	(I,claim,8)
para	(I,claim,7)
o	(I,claim,6)
futuro	(I,claim,5)
político	(I,claim,4)
de	(I,claim,3)
Merkel	(I,claim,2)
.	(O,|,|)
Durante	(I,premise,0)
este	(I,premise,0)
ano	(I,premise,0)
,	(I,premise,0)
haverá	(I,premise,0)
cinco	(I,premise,0)
eleições	(I,premise,0)
regionais	(I,premise,0)
nos	(I,premise,0)
Lander	(I,premise,0)
.	(O,|,|)
Se	(O,|,|)
a	(O,|,|)
CDU	(O,|,|)
sofrer	(O,|,|)
maus	(O,|,|)
resultados	(O,|,|)
–	(O,|,|)
e	(O,|,|)
sabe	(O,|,|)
-se	(O,|,|)
como	(O,|,|)
as	(O,|,|)
eleições	(O,|,|)
regionais	(O,|,|)
costumam	(O,|,|)
ser	(O,|,|)
complicadas	(O,|,|)
para	(O,|,|)
os	(O,|,|)
partidos	(O,|,|)
no	(O,|,|)
poder	(O,|,|)
–	(O,|,|)
a	(O,|,|)
vida	(O,|,|)
ficará	(O,|,|)
muito	(O,|,|)
difícil	(O,|,|)
para	(O,|,|)
Merkel	(O,|,|)
.	(O,|,|)
